NO ./xpm/n.xpm
SO ./xpm/s.xpm
WE ./xpm/w.xpm
EA ./xpm/e.xpm
F 0,0,0
C 25,32,45

1111111111111
1000000000001
1000000000001
1000000000001
1000000100011
100000N000011
1000000000011
1000000000001
1000100000001
1000000000001
1111111111111
