NO ./xpm/windows.xpm
SO ./xpm/photo.xpm
WE ./xpm/w.xpm
EA ./xpm/e.xpm
F 0,0,0
C 36,36,36

11111111111111111111
10000000000000000001
10000000000000000101
10000000000000000101
11111111111111111101
10000000000000000001
11111111111111111001
10000000000000000001
10000000011111111111
10000000000000000001
10111111111111111111
10000000000000000001
11111111111111110111
10000000000000000111
10111111111111111111
10100001000000000011
10100001010000110011
10111111111111100011
1000000000000000W011
11111111111111111111
